22222222222
20000000000
20000000006
20000000007
20000000005
22222222222