111111111111111
100000000010001
100000000010001
100000000010001
100000000010001
100000000010001
100000111110001
100000000000001
100000000000001
100000000000001
100111100000001
100000000000001
111111111111111